tileset.png 7 38 38
9 10
4	4	4	4	4	4	4	4	4	4
4	1	1	1	1	4	4	4	4	4
4	4	1	1	1	1	1	4	4	4
4	4	1	1	1	1	1	1	1	4
4	4	1	1	1	1	1	1	1	4
4	1	1	1	1	1	1	4	4	4
4	1	1	1	1	1	1	1	4	4
4	4	1	1	1	1	1	1	4	4
4	4	1	1	1	1	1	1	4	4